R 720 480

NO ./resources/images/brick.xpm

SO ./resources/images/metal.xpm

WE ./resources/images/stone.xpm

EA ./resources/images/wood.xpm

FL ./resources/images/grass.xpm

CL ./resources/images/sky.xpm

S ./resources/images/barrel.xpm

T ./resources/images/table.xpm

C 0,0,0                                 

F 140,114,108

        11111111111111111111111
        100000000011000000000031
        1001200021112000000000031
        100100000000000000E000031
 1111111100100002111020000000031
1100000000010202011101111101111
13020200000111011102020012021
11110111111111011100000213031
10020200000002011100000000001
10000000000000001100000212001
10000011100000021120000010001
1000001 100000000000000010001
10000211120000021102000010001
10000000000000001101111110001
10000021112000011100000210001
10000001 1000001 100000310001
11111111 1111111 111111111111
